ください - kudasai
Give me

おねがいします - onegai shimas
Please

どうも - doumo
Thanks

ありがとう - arigatou
Thank you

すみません - sumimasen
Sorry, excuse me

はい - hai
Yes

いいえ - iie
No



-------------


こんにちは (konnichiwa): Hello
おはようございます (ohayou gozaimasu): Good morning
はじめまして (hajime mashite): Nice to meet you 
ありがとうございます (arigatou gozaimasu): Thank you
失礼いたします (shitsurei itashimasu): Please excuse me

どこ (doko):  where
左 (hidari): left
右 (migi): right
真っ直ぐ (massugu): straight
手前 (temae): in front of/near


おすすめ (osusume): recommendation
お冷や (ohiya): cold water 
お水 (omizu): water
お会計 / お勘定 (okaikei/okanjou): bill


いくら (ikura): how much
試着 (shichaku): to try on clothes
現金 (genkin): cash
カード (kaado): card 
一括払い (ikkatsu barai): one-time payment 
大丈夫です (daijoubu desu): that’s fine
袋 (fukuro): bag 


助けて (tasukete): Please help me
英語 (eigo): English 
交番 (kouban): police station
